Year,Pop,Rock,Jazz,Classical,HipHop,Country
2019,5000,10000,7000,4000,8000,6000
2020,5500,11000,7500,4500,8500,6500
2021,6000,12000,8000,5000,9000,7000
2022,6500,13000,8500,5500,9500,7500
2023,7000,14000,9000,6000,10000,8000
2024,7500,15000,9500,6500,10500,8500
2025,8000,16000,10000,7000,11000,9000
2026,8500,17000,10500,7500,11500,9500
2027,9000,18000,11000,8000,12000,10000
2028,9500,19000,11500,8500,12500,10500
