Month,Math,Science,History,Art,Music
2023-01,300,250,200,150,100
2023-02,320,270,220,160,110
2023-03,340,290,240,170,120
2023-04,360,310,260,180,130
2023-05,380,330,280,190,140
2023-06,400,350,300,200,150
2023-07,420,370,320,210,160
2023-08,440,390,340,220,170
2023-09,460,410,360,230,180
2023-10,480,430,380,240,190
2023-11,500,450,400,250,200
2023-12,520,470,420,260,210
