Month,Jazz,Classical,Rock,Pop,Hip-Hop
January,80,90,70,150,120
February,85,95,75,160,125
March,90,100,80,170,130
April,95,105,85,180,135
May,100,110,90,190,140
June,105,115,95,200,145
July,110,120,100,210,150
August,115,125,105,220,155
September,120,130,110,230,160
October,125,135,115,240,165
November,130,140,120,250,170
December,135,145,125,260,175
