Month,Instagram,Twitter,Facebook,Snapchat,TikTok
Jan,300,120,200,180,150
Feb,320,130,210,190,160
Mar,340,140,220,200,170
Apr,360,150,230,210,180
May,380,160,240,220,190
Jun,400,170,250,230,200
Jul,420,180,260,240,210
Aug,440,190,270,250,220
Sep,460,200,280,260,230
Oct,480,210,290,270,240
Nov,500,220,300,280,250
Dec,520,230,310,290,260
