Month,Europe,Asia,North America,South America,Africa
January,25000,15000,30000,10000,5000
February,27000,16000,31000,10500,5500
March,28000,17000,32000,11000,6000
April,29000,18000,33000,11500,6500
May,30000,19000,34000,12000,7000
June,31000,20000,35000,12500,7500
July,32000,21000,36000,13000,8000
August,33000,22000,37000,13500,8500
September,34000,23000,38000,14000,9000
October,35000,24000,39000,14500,9500
November,36000,25000,40000,15000,10000
December,37000,26000,41000,15500,10500
